"filename", "language", "Dart", "comment", "blank", "total"
"c:\Users\Magd\Documents\Flutter Projects\ebuy\lib\Controller\Home\CheckOutController.dart", "Dart", -2, 0, 0, -2
"c:\Users\Magd\Documents\Flutter Projects\ebuy\lib\Controller\Home\HomePageController.dart", "Dart", 1, 0, 0, 1
"c:\Users\Magd\Documents\Flutter Projects\ebuy\lib\Controller\Home\SearchController.dart", "Dart", 8, 0, 1, 9
"c:\Users\Magd\Documents\Flutter Projects\ebuy\lib\Controller\Home\SettingsControllers\AccountController.dart", "Dart", 8, 0, 1, 9
"c:\Users\Magd\Documents\Flutter Projects\ebuy\lib\Controller\Home\SettingsControllers\AddressController.dart", "Dart", 7, 0, 0, 7
"c:\Users\Magd\Documents\Flutter Projects\ebuy\lib\Controller\Home\SettingsControllers\GiftCardController.dart", "Dart", 8, 0, 0, 8
"c:\Users\Magd\Documents\Flutter Projects\ebuy\lib\Controller\Home\SettingsControllers\OrdersController.dart", "Dart", 4, 0, -1, 3
"c:\Users\Magd\Documents\Flutter Projects\ebuy\lib\Controller\Home\SettingsControllers\PaymentController.dart", "Dart", 2, 0, 0, 2
"c:\Users\Magd\Documents\Flutter Projects\ebuy\lib\Controller\Home\favouritePageController.dart", "Dart", 4, 0, 0, 4
"c:\Users\Magd\Documents\Flutter Projects\ebuy\lib\core\constant\AppWords.dart", "Dart", 272, 15, 16, 303
"c:\Users\Magd\Documents\Flutter Projects\ebuy\lib\core\function\UiFunctions\Dialogs\AppWebsiteDialog.dart", "Dart", 8, 0, 2, 10
"c:\Users\Magd\Documents\Flutter Projects\ebuy\lib\core\function\UiFunctions\Dialogs\confirmPaymentDialog.dart", "Dart", 1, 0, 0, 1
"c:\Users\Magd\Documents\Flutter Projects\ebuy\lib\core\localization\handleLanguageApi.dart", "Dart", 10, 0, 2, 12
"c:\Users\Magd\Documents\Flutter Projects\ebuy\lib\data\dataSource\Static\static.dart", "Dart", -5, 0, 0, -5
"c:\Users\Magd\Documents\Flutter Projects\ebuy\lib\routes.dart", "Dart", -5, 0, 0, -5
"c:\Users\Magd\Documents\Flutter Projects\ebuy\lib\view\Widgets\Home\Cart\checkOut\payment\TermsAndConditionText.dart", "Dart", 1, 0, 0, 1
"c:\Users\Magd\Documents\Flutter Projects\ebuy\lib\view\Widgets\Home\Favourite\SaveditemsListView.dart", "Dart", 1, 0, 0, 1
"c:\Users\Magd\Documents\Flutter Projects\ebuy\lib\view\Widgets\Home\HomePage\NewTrend\DialogButton.dart", "Dart", -1, 0, -2, -3
"c:\Users\Magd\Documents\Flutter Projects\ebuy\lib\view\Widgets\Home\HomePage\NewTrend\FilterPageWidgets\FilterDialogContent.dart", "Dart", -1, 0, -1, -2
"c:\Users\Magd\Documents\Flutter Projects\ebuy\lib\view\Widgets\Home\HomePage\NewTrend\FilterPageWidgets\FilterPageHeaders.dart", "Dart", -1, 0, -2, -3
"c:\Users\Magd\Documents\Flutter Projects\ebuy\lib\view\Widgets\Home\HomePage\NewTrend\ItemsSetting.dart", "Dart", -2, 0, -1, -3
"c:\Users\Magd\Documents\Flutter Projects\ebuy\lib\view\Widgets\Home\HomePage\RecentlyGridView.dart", "Dart", 2, 0, 0, 2
"c:\Users\Magd\Documents\Flutter Projects\ebuy\lib\view\Widgets\Home\HomePage\shared\PageHeadersWithCartIcon.dart", "Dart", -3, 0, -2, -5
"c:\Users\Magd\Documents\Flutter Projects\ebuy\lib\view\Widgets\Home\Settings\GiftCardWidgets\GiftCardExample.dart", "Dart", 1, 0, 0, 1
"c:\Users\Magd\Documents\Flutter Projects\ebuy\lib\view\Widgets\Home\Settings\GiftCardWidgets\NoGiftCardPage.dart", "Dart", 1, 0, 0, 1
"c:\Users\Magd\Documents\Flutter Projects\ebuy\lib\view\Widgets\Home\Settings\OrdersWidgets\OrdersCard.dart", "Dart", 1, 0, 0, 1
"c:\Users\Magd\Documents\Flutter Projects\ebuy\lib\view\Widgets\Home\Settings\OrdersWidgets\OrdersRichText.dart", "Dart", 37, 0, 3, 40
"c:\Users\Magd\Documents\Flutter Projects\ebuy\lib\view\screens\Home\Cart\OrderSuccess.dart", "Dart", 1, 0, 0, 1
"c:\Users\Magd\Documents\Flutter Projects\ebuy\lib\view\screens\Home\Settings\AccountPages\ContactPage.dart", "Dart", -8, 0, -3, -11
"c:\Users\Magd\Documents\Flutter Projects\ebuy\lib\view\screens\Home\Settings\AccountPages\GiftCardsPages\AddGiftCardPage.dart", "Dart", 1, 0, 0, 1
"c:\Users\Magd\Documents\Flutter Projects\ebuy\lib\view\screens\Home\Settings\AccountPages\OrdersPages\OrderTrack.dart", "Dart", -34, 0, -2, -36
"c:\Users\Magd\Documents\Flutter Projects\ebuy\lib\view\screens\Home\Settings\AccountPages\PaymentPages\PaymentMethods.dart", "Dart", 2, 0, 0, 2
"c:\Users\Magd\Documents\Flutter Projects\ebuy\lib\view\screens\Home\Settings\SettingsPages\notifications.dart", "Dart", 1, 0, 0, 1
"Total", "-", 320, 15, 11, 346